/admin/	django.contrib.admin.sites.index	admin:index
/admin/<app_label>/	django.contrib.admin.sites.app_index	admin:app_list
/admin/<url>	django.contrib.admin.sites.catch_all_view
/admin/auth/group/	django.contrib.admin.options.changelist_view	admin:auth_group_changelist
/admin/auth/group/<path:object_id>/	django.views.generic.base.RedirectView
/admin/auth/group/<path:object_id>/change/	django.contrib.admin.options.change_view	admin:auth_group_change
/admin/auth/group/<path:object_id>/delete/	django.contrib.admin.options.delete_view	admin:auth_group_delete
/admin/auth/group/<path:object_id>/history/	django.contrib.admin.options.history_view	admin:auth_group_history
/admin/auth/group/add/	django.contrib.admin.options.add_view	admin:auth_group_add
/admin/auth/user/	django.contrib.admin.options.changelist_view	admin:auth_user_changelist
/admin/auth/user/<id>/password/	django.contrib.auth.admin.user_change_password	admin:auth_user_password_change
/admin/auth/user/<path:object_id>/	django.views.generic.base.RedirectView
/admin/auth/user/<path:object_id>/change/	django.contrib.admin.options.change_view	admin:auth_user_change
/admin/auth/user/<path:object_id>/delete/	django.contrib.admin.options.delete_view	admin:auth_user_delete
/admin/auth/user/<path:object_id>/history/	django.contrib.admin.options.history_view	admin:auth_user_history
/admin/auth/user/add/	django.contrib.auth.admin.add_view	admin:auth_user_add
/admin/autocomplete/	django.contrib.admin.sites.autocomplete_view	admin:autocomplete
/admin/jsi18n/	django.contrib.admin.sites.i18n_javascript	admin:jsi18n
/admin/login/	django.contrib.admin.sites.login	admin:login
/admin/logout/	django.contrib.admin.sites.logout	admin:logout
/admin/password_change/	django.contrib.admin.sites.password_change	admin:password_change
/admin/password_change/done/	django.contrib.admin.sites.password_change_done	admin:password_change_done
/admin/r/<path:content_type_id>/<path:object_id>/	django.contrib.contenttypes.views.shortcut	admin:view_on_site
/api/v1/	rest_framework.routers.APIRootView	api-root
/api/v1/	rest_framework.routers.APIRootView	api-root
/api/v1/	rest_framework.routers.APIRootView	api-root
/api/v1/	rest_framework.routers.APIRootView	api-root
/api/v1/	rest_framework.routers.APIRootView	api-root
/api/v1/<drf_format_suffix:format>	rest_framework.routers.APIRootView	api-root
/api/v1/<drf_format_suffix:format>	rest_framework.routers.APIRootView	api-root
/api/v1/<drf_format_suffix:format>	rest_framework.routers.APIRootView	api-root
/api/v1/<drf_format_suffix:format>	rest_framework.routers.APIRootView	api-root
/api/v1/<drf_format_suffix:format>	rest_framework.routers.APIRootView	api-root
/api/v1/bom-lines/	bom.views.bom_line_views.BomLineViewSet	bom-line-list
/api/v1/bom-lines/<pk>/	bom.views.bom_line_views.BomLineViewSet	bom-line-detail
/api/v1/bom-lines/<pk>/delete/	bom.views.bom_line_views.BomLineViewSet	bom-line-delete
/api/v1/bom-lines/<pk>/delete\.<format>/	bom.views.bom_line_views.BomLineViewSet	bom-line-delete
/api/v1/bom-lines/<pk>/recover/	bom.views.bom_line_views.BomLineViewSet	bom-line-recover
/api/v1/bom-lines/<pk>/recover\.<format>/	bom.views.bom_line_views.BomLineViewSet	bom-line-recover
/api/v1/bom-lines/<pk>\.<format>/	bom.views.bom_line_views.BomLineViewSet	bom-line-detail
/api/v1/bom-lines\.<format>/	bom.views.bom_line_views.BomLineViewSet	bom-line-list
/api/v1/boms/	bom.views.bom_views.BomViewSet	bom-list
/api/v1/boms/<pk>/	bom.views.bom_views.BomViewSet	bom-detail
/api/v1/boms/<pk>/delete/	bom.views.bom_views.BomViewSet	bom-delete
/api/v1/boms/<pk>/delete\.<format>/	bom.views.bom_views.BomViewSet	bom-delete
/api/v1/boms/<pk>/recover/	bom.views.bom_views.BomViewSet	bom-recover
/api/v1/boms/<pk>/recover\.<format>/	bom.views.bom_views.BomViewSet	bom-recover
/api/v1/boms/<pk>\.<format>/	bom.views.bom_views.BomViewSet	bom-detail
/api/v1/boms\.<format>/	bom.views.bom_views.BomViewSet	bom-list
/api/v1/companies/	core.views.company_views.CompanyViewSet	company-list
/api/v1/companies/<pk>/	core.views.company_views.CompanyViewSet	company-detail
/api/v1/companies/<pk>/delete/	core.views.company_views.CompanyViewSet	company-delete
/api/v1/companies/<pk>/delete\.<format>/	core.views.company_views.CompanyViewSet	company-delete
/api/v1/companies/<pk>/recover/	core.views.company_views.CompanyViewSet	company-recover
/api/v1/companies/<pk>/recover\.<format>/	core.views.company_views.CompanyViewSet	company-recover
/api/v1/companies/<pk>\.<format>/	core.views.company_views.CompanyViewSet	company-detail
/api/v1/companies\.<format>/	core.views.company_views.CompanyViewSet	company-list
/api/v1/contacts/	core.views.contact_views.ContactViewSet	contact-list
/api/v1/contacts/<pk>/	core.views.contact_views.ContactViewSet	contact-detail
/api/v1/contacts/<pk>/delete/	core.views.contact_views.ContactViewSet	contact-delete
/api/v1/contacts/<pk>/delete\.<format>/	core.views.contact_views.ContactViewSet	contact-delete
/api/v1/contacts/<pk>/recover/	core.views.contact_views.ContactViewSet	contact-recover
/api/v1/contacts/<pk>/recover\.<format>/	core.views.contact_views.ContactViewSet	contact-recover
/api/v1/contacts/<pk>\.<format>/	core.views.contact_views.ContactViewSet	contact-detail
/api/v1/contacts\.<format>/	core.views.contact_views.ContactViewSet	contact-list
/api/v1/inventory-locations/	inventory.views.inventory_location_views.InventoryLocationViewSet	inventory-location-list
/api/v1/inventory-locations/<pk>/	inventory.views.inventory_location_views.InventoryLocationViewSet	inventory-location-detail
/api/v1/inventory-locations/<pk>/delete/	inventory.views.inventory_location_views.InventoryLocationViewSet	inventory-location-delete
/api/v1/inventory-locations/<pk>/delete\.<format>/	inventory.views.inventory_location_views.InventoryLocationViewSet	inventory-location-delete
/api/v1/inventory-locations/<pk>/recover/	inventory.views.inventory_location_views.InventoryLocationViewSet	inventory-location-recover
/api/v1/inventory-locations/<pk>/recover\.<format>/	inventory.views.inventory_location_views.InventoryLocationViewSet	inventory-location-recover
/api/v1/inventory-locations/<pk>\.<format>/	inventory.views.inventory_location_views.InventoryLocationViewSet	inventory-location-detail
/api/v1/inventory-locations/dropdown/	inventory.views.dropdown_views.InventoryLocationDropdownView
/api/v1/inventory-locations\.<format>/	inventory.views.inventory_location_views.InventoryLocationViewSet	inventory-location-list
/api/v1/material-demands/	procurement.views.material_demand_views.MaterialDemandViewSet	material-demand-list
/api/v1/material-demands/<pk>/	procurement.views.material_demand_views.MaterialDemandViewSet	material-demand-detail
/api/v1/material-demands/<pk>/delete/	procurement.views.material_demand_views.MaterialDemandViewSet	material-demand-delete
/api/v1/material-demands/<pk>/delete\.<format>/	procurement.views.material_demand_views.MaterialDemandViewSet	material-demand-delete
/api/v1/material-demands/<pk>/recover/	procurement.views.material_demand_views.MaterialDemandViewSet	material-demand-recover
/api/v1/material-demands/<pk>/recover\.<format>/	procurement.views.material_demand_views.MaterialDemandViewSet	material-demand-recover
/api/v1/material-demands/<pk>\.<format>/	procurement.views.material_demand_views.MaterialDemandViewSet	material-demand-detail
/api/v1/material-demands\.<format>/	procurement.views.material_demand_views.MaterialDemandViewSet	material-demand-list
/api/v1/materials/	core.views.material_views.MaterialViewSet	material-list
/api/v1/materials/<pk>/	core.views.material_views.MaterialViewSet	material-detail
/api/v1/materials/<pk>/delete/	core.views.material_views.MaterialViewSet	material-delete
/api/v1/materials/<pk>/delete\.<format>/	core.views.material_views.MaterialViewSet	material-delete
/api/v1/materials/<pk>/recover/	core.views.material_views.MaterialViewSet	material-recover
/api/v1/materials/<pk>/recover\.<format>/	core.views.material_views.MaterialViewSet	material-recover
/api/v1/materials/<pk>\.<format>/	core.views.material_views.MaterialViewSet	material-detail
/api/v1/materials\.<format>/	core.views.material_views.MaterialViewSet	material-list
/api/v1/procurement-order-lines/	procurement.views.procurement_order_line_views.ProcurementOrderLineViewSet	procurement-order-line-list
/api/v1/procurement-order-lines/<pk>/	procurement.views.procurement_order_line_views.ProcurementOrderLineViewSet	procurement-order-line-detail
/api/v1/procurement-order-lines/<pk>/delete/	procurement.views.procurement_order_line_views.ProcurementOrderLineViewSet	procurement-order-line-delete
/api/v1/procurement-order-lines/<pk>/delete\.<format>/	procurement.views.procurement_order_line_views.ProcurementOrderLineViewSet	procurement-order-line-delete
/api/v1/procurement-order-lines/<pk>/recover/	procurement.views.procurement_order_line_views.ProcurementOrderLineViewSet	procurement-order-line-recover
/api/v1/procurement-order-lines/<pk>/recover\.<format>/	procurement.views.procurement_order_line_views.ProcurementOrderLineViewSet	procurement-order-line-recover
/api/v1/procurement-order-lines/<pk>\.<format>/	procurement.views.procurement_order_line_views.ProcurementOrderLineViewSet	procurement-order-line-detail
/api/v1/procurement-order-lines\.<format>/	procurement.views.procurement_order_line_views.ProcurementOrderLineViewSet	procurement-order-line-list
/api/v1/procurement-orders/	procurement.views.procurement_order_views.ProcurementOrderViewSet	procurement-order-list
/api/v1/procurement-orders/<pk>/	procurement.views.procurement_order_views.ProcurementOrderViewSet	procurement-order-detail
/api/v1/procurement-orders/<pk>/allowed-transitions/	procurement.views.procurement_order_views.ProcurementOrderViewSet	procurement-order-allowed-transitions
/api/v1/procurement-orders/<pk>/allowed-transitions\.<format>/	procurement.views.procurement_order_views.ProcurementOrderViewSet	procurement-order-allowed-transitions
/api/v1/procurement-orders/<pk>/delete/	procurement.views.procurement_order_views.ProcurementOrderViewSet	procurement-order-delete
/api/v1/procurement-orders/<pk>/delete\.<format>/	procurement.views.procurement_order_views.ProcurementOrderViewSet	procurement-order-delete
/api/v1/procurement-orders/<pk>/recover/	procurement.views.procurement_order_views.ProcurementOrderViewSet	procurement-order-recover
/api/v1/procurement-orders/<pk>/recover\.<format>/	procurement.views.procurement_order_views.ProcurementOrderViewSet	procurement-order-recover
/api/v1/procurement-orders/<pk>/set-status/	procurement.views.procurement_order_views.ProcurementOrderViewSet	procurement-order-change-status
/api/v1/procurement-orders/<pk>/set-status\.<format>/	procurement.views.procurement_order_views.ProcurementOrderViewSet	procurement-order-change-status
/api/v1/procurement-orders/<pk>\.<format>/	procurement.views.procurement_order_views.ProcurementOrderViewSet	procurement-order-detail
/api/v1/procurement-orders\.<format>/	procurement.views.procurement_order_views.ProcurementOrderViewSet	procurement-order-list
/api/v1/sales-orders/	sales.views.sales_order_views.SalesOrderViewSet	sales-order-list
/api/v1/sales-orders/<pk>/	sales.views.sales_order_views.SalesOrderViewSet	sales-order-detail
/api/v1/sales-orders/<pk>\.<format>/	sales.views.sales_order_views.SalesOrderViewSet	sales-order-detail
/api/v1/sales-orders\.<format>/	sales.views.sales_order_views.SalesOrderViewSet	sales-order-list
/api/v1/variable-costs/	sales.views.variable_cost_views.VariableCostViewSet	variable-cost-list
/api/v1/variable-costs/<pk>/	sales.views.variable_cost_views.VariableCostViewSet	variable-cost-detail
/api/v1/variable-costs/<pk>/delete/	sales.views.variable_cost_views.VariableCostViewSet	variable-cost-delete
/api/v1/variable-costs/<pk>/delete\.<format>/	sales.views.variable_cost_views.VariableCostViewSet	variable-cost-delete
/api/v1/variable-costs/<pk>/recover/	sales.views.variable_cost_views.VariableCostViewSet	variable-cost-recover
/api/v1/variable-costs/<pk>/recover\.<format>/	sales.views.variable_cost_views.VariableCostViewSet	variable-cost-recover
/api/v1/variable-costs/<pk>\.<format>/	sales.views.variable_cost_views.VariableCostViewSet	variable-cost-detail
/api/v1/variable-costs\.<format>/	sales.views.variable_cost_views.VariableCostViewSet	variable-cost-list
/redoc/	drf_yasg.views.SchemaView	schema-redoc
/swagger/	drf_yasg.views.SchemaView	schema-swagger-ui
